The Hero of Yorkshire
An Interactive Fiction by ImprobabilityGaming
Release 1 / Serial number 151122 / Inform 7 build 6L38 (I6/v6.33 lib 6/12N) SD

Forest Path
You awake to the sound of leaves rustling as the crisp autumn air flows through the surrounding forest. Slowly recovering from the grogginess of waking up you look around yourself to examine your surroundings. A few rays of sunlight pierce the thick foliage that looms several feet above your head seemingly endlessly throughout the area. You feel the warmth of the sun's rays washing over your body as you hear a sudden snap and quickly jolt your head. Today is the day you visit one of your usual spots, Yorkshire, a few ways south of here.

>look around
You can't see any such thing.

>where am i
That's not a verb I recognise.

>n
You can't go that way.

>s
Path 1
You see a smoke coming off from far away.

>n
Forest
Awaking from journey, you look around where you slept.  A burnt logs, a bag, and few leftover meat can be seen.  You try to remember yesterday, but it only faints away, but the only thing you remember is that you are trying to get back home and you also remember it's close by.

Deckard Cain: "Hello, my friend!  Stay awhile and listen!"

>look aorund
You can't see any such thing.

>look around
You can't see any such thing.

>look
Forest
Awaking from journey, you look around where you slept.  A burnt logs, a bag, and few leftover meat can be seen.  You try to remember yesterday, but it only faints away, but the only thing you remember is that you are trying to get back home and you also remember it's close by.

Deckard Cain: "Hello, my friend!  Stay awhile and listen!"

There is only Deckard Cain here.

* * *

>w
You can't go that way.

>e
You can't go that way.

>s
Path 1
You see a smoke coming off from far away.

>w
You can't go that way.

>s
Outskirt
 Now a town can be seen not so far from where you are.  You are delighted to see a town and to see human beings again, although you are not so sure why these feelings suddenly come up when you see the town. However, as you go closer to town, you notice that town is attacked by something.   There are burnt houses, dead cows, and dead people everywhere.  The smell of rotting corpses are toxicating.

>w
You can't go that way.

>s
Town Entrance
A guard is standing.  He seems to be annoyed with the smell of corpses.

You can see Wilhelm the guard here.

>s
Road 1
People who are walking by glance at you silently and pass by with haste.

>s
Town Square
 Even though it should have been the most busiest place of the town, Town Square only has few people.  Few guards are taking watch and some town folks are wondering around. 

A well can be seen in the middle., but no one dares to get close to the well.

>s
Road 2
A Sculpture of Angel is displayed.

>s
Church
The door opens with a squeaking sound.  Inside Church, a luminescence light comes through a stained glass which portrays a fight between the devil and angel inside one person. Few people are mumbling prayers.  

You can see John the Priest here.

>s
You can't go that way.

>s
You can't go that way.

>a
That's not a verb I recognise.

>w
You can't go that way.

>d
You can't go that way.

>e
You can't go that way.

>n
Road 2
A Sculpture of Angel is displayed.

>e
You can't go that way.

>n
Town Square
 Few guards are taking watch and some town folks are wondering around. 

A well can be seen in the middle., but no one dares to get close to the well.

>e
Road 3

>e
Farmer's House
You can see a house barely intact.  The farm on the east burned entirely. It looks as though the cattle are loose. A farmer is trying to gather his cattles with little success.  "That monster!  We should have killed it when we had the chance! Hey, traveler, help me getting these cattles, and I'll give you a good reward. "  You decide to help the farmer. 

You can see Martin the Farmer here.

>e
Farm 1
The farm is big, but now it's all burned down.   Nothing is left but some grass.  The cattles are all running over the place.  You must catch them all.

You can see Cattle 1, Cattle 2, Cattle 3 and some grass here.

>e
You can't go that way.

>e
You can't go that way.

* * *

>s
Outskirt
You reach what appears to be the outskirts of a small town. The worn-down houses nearby appear as if they've been demolished. Still, it might be your only chance of contact.  As you step closer, the smell of death singes the inside of your nostrils, and you can see that the town is in a shambles resulting from a massacre.

>s
Town Entrance
A guard is standing. He seems to be annoyed by the smell of corpses.

You can see Wilhelm the guard here.

>s
Town Entrance
A guard is standing.  He seems to be annoyed with the smell of corpses.

You can see Wilhelm the guard here.

* * *

>s
Town Square
 Even though it should have been the most busiest place of the town, Town Square only has few people.  Few guards are taking watch and some town folks are wondering around. 

A well can be seen in the middle., but no one dares to get close to the well.

>w
Road 4

>w
Ore Mine
You see Glittering Ore Veins!

>e
Road 4

>e
Town Square
 Few guards are taking watch and some town folks are wondering around. 

A well can be seen in the middle., but no one dares to get close to the well.

>s
Road 2
A Sculpture of Angel is displayed.

* * *

>s
Church
The door opens with a squeaking sound.  Inside Church, a luminescence light comes through a stained glass which portrays a fight between the devil and angel inside one person. Few people are mumbling prayers.  

You can see John the Priest here.

>ask priest
(for John the Priest)
(John the Priest first taking John the Priest)
John the Priest has better things to do.

>ask priest about quest
"In order for you to receive holy water, I must first obtain water from the well in the middle of our town."

>ask priest about house
There is no reply.

>ask priest about town
This town has stood for decades, and will continue to stand despite this monster lurking about.

* * *

>s
Town Entrance
A guard is standing. He seems to be annoyed by the smell of corpses.

You can see Wilhelm the guard here.

>ask guard about quest
What do you mean quest? Do I look like an NPC to you?

* * *

>n
You can't go that way.

>n
You can't go that way.

* * *

>s
Path 1
You see a smoke coming off from far away.

>s
Outskirt
 Now a town can be seen not so far from where you are.  You are delighted to see a town and to see human beings again, although you are not so sure why these feelings suddenly come up when you see the town. However, as you go closer to town, you notice that town is attacked by something.   There are burnt houses, dead cows, and dead people everywhere.  The smell of rotting corpses are toxicating.

>s
Town Entrance
A guard is standing.  He seems to be annoyed with the smell of corpses.

You can see Wilhelm the guard here.

* * *

>s
Town Square
 Even though it should have been the most busiest place of the town, Town Square only has few people.  Few guards are taking watch and some town folks are wondering around. 

A well can be seen in the middle., but no one dares to get close to the well.

>e
Road 3